....................
.....###########....
...............#....
...............#....
....................
########............
....................
....................
....................
.........###........
.................#..
.................#..
.................#..
.................#..
.................#..
.................#..
.................#..
.................#..
....................
....................