....................
.....###########....
...............#....
...............#....
....................
########............
............########
....................
....................
.........###........
..#..............#..
..#..............#..
..#..............#..
..#..............#..
..#..............#..
..#..............#..
..#..............#..
..........########..
#######.............
....................